NO srcs/textures/wall1.XPM
SO srcs/textures/wall2.XPM
WE srcs/textures/wall3.XPM
EA srcs/textures/wall4.XPM
F 25          ,              184        ,                        11
C 117,225,253
 111111111111111111111111111111111111111111111111111111111111111111111111111111111111111
1000000000000000000000000000000000000000000000000000000000000000000000000000000000000001
1000000000000000000000000000000000000000000000000000000000000000000000000000000000000001
1000000000000000000000000000000000000000000000000000000000000000000000000000000000000001
1000000000000000000000100100000000000000000000000000000000000000000000000000000000000001
1000000000000000000001000100000000000000000000000000000000000000000000000000000000000001
1000000000000000000010000010000000000000000000000000000000000000000000000000000000000001
1000000000000000000100000010000000000000000000000000000000000000011111111111111111111111
1100000000000000000100000000100000000000011111111110000000000000000000000000000000000001
1000000000000000010000010000010000000000000000000000000000000000000000000000111111111111
1100000000000000010000010000001000000000000000000111111111111111111100000000000000000001
1000000000000001000001000000001100000000000000000000000000000000000000101111111111111111
1100000000000001000001000000000001111111111111111110000000000000000000010000001000000011
1000000000000100000000000000000010000000000000000000000000000000000000100000010000000011
1000000000001000000100000000000000100000000000000000000000000000000000100000010000000011
1000000000010000001000000000000000010000000000000000000000000000000000100000010000000011
1000000000100000010000000010000000000100000000001111111000000000000000100000010000001101
1000000001000000000000001000000000000100000000000000000000000000000000100000010000000011
1000000010000000000000010000000000000000000000000000000000000000000000100000010000000011
1000000100000000000000100000000000000010000000000000000000000000000000100000010000000001
1000001000000000000001000000000000000001000000000000000000000000W00000000000000000000011
1000010000000000000010000000000000000000100000000000000000000000000000000000000000000011
1000100000000000000000000000000000000000000000000000000000000000000000000000000000000011
1111111111111111111111111111111111111111111111111111111111111111111111111111111111111111