NO srcs/textures/wall1.XPM
SO srcs/textures/wall2.XPM
WE srcs/textures/wall3.XPM
EA srcs/textures/wall4.XPM
F 101,0,101
C 101,0,101
111111
100001
10W001
101001
111111